NO ./pics/wall1.png


WE ./pics/wall.png
SO ./pics/wall2.png

EA ./pics/wall3.png

C 3,173,252

F 21,82,10




111111111111111111111111111111111
1000000000000N00000000000000000111111111111111
10000000000000000000000000000000000000000000001
10000000000000000000000000000000000010000000001
10000000000000000000000000000000000010000000001
10000000000000000000000000000000000010000000001
10000000000000000000000000000000000010000000001
10000000000000000000000000000000000010000000001
10000000000000000000000000000000000010000000001
10000000000000000000000000000000000010000000001
10000000000000000000000000000000000010000000001
11111111111111111111111111111111111111111111111
