NO ./pics/wall1.png

WE ./pics/wall.png
SO ./pics/wall2.png
EA ./pics/wall3.png


C 21,82,10
F 3,173,252

1111111111111111111111111111111111
10000000000000000000100000000001111111111111111
10000000000000000000100000000000000000000000001
11110000000000000000100000000000000010000000000
11111111111111111111111111111111111111111111111


11111111111111111111111111111111111111111111111
11110000000000000000100000000000000010000000001
11100000000000011111100000000000000000000010001
1000000000000001    1N0000000000000100000000001
11110000000000011111100000000000000010000000001
11100000000000000000100000000000000010000000001
11110000000000000000100000000000000010000000001
10000000000000000000100000000000000010000000001
11111111111111111111111111111111111111111111111
