NO ./pics/purplestone.png

WE ./pics/redbrick.png
SO ./pics/bluestone.png
EA ./pics/greystone.png


C 21,82,10
F 3,173,252

111111111111111111111111111111111
10000000000000000000000000000001111111111111111
10000000000000001111110000000000000000000000001
1000000000000000100S010000111100000010000000001
10000000000000001000010000111100000010000000001
10000000000000001111110000000000000010000000001
11111100000000000000000000000000000000000100001
10000000000000000000000000000000000010000000001
10000000000000000000000000000000000010000000001
10000000000000000000000000000000000010000000001
10000000000000101001000000000000000001000000001
11111111111111111111111111111111111111111111111
